11111
1E1P1
10111
1C001
11111
