11111
1E0P1
100001
1C001
11111
