11111
1E0P1
10001
10001
11111
