11111
1E0P1
11C01
1C101
11111
