11111
1E0P1
11001
1C101
11111
