11111
1E1P1
10011
1C001
11111
