11111
1E0P1
100P1
1C001
11111
