11111
1E0P1
10000
1C001
11111
