1111111111111111111111111
1000000000000000000000001
100000000000000000000B001
1000000000000000000000001
1000000000000000000000001
10000000000P0000000000001
1000000000000000000000001
1000000000000000000000001
10000000000C000000000E001
1000000000000000000000001
1000000000000000000000001
1000000000000000000000001
1000000000000000000000001
1111111111111111111111111