11111111
1E1000B1
10000011
10000001
10000001
10000011
11C100P1
11111111
