11111111
1E0000B1
1000000
10000001
10000001
10000001
11C000P1
11111111