11111
1ECP1
1CCC1
1CCC1
11111
