11111111
11E00001
100P0B01
11C00B01
11111111