11111111111111111111111111
10000000000000000000000001
10000000000000000000000001
10000000000000000C00000001
10000000000000000000000001
10000000000000000000000001
10000000000000000000000001
10000000010000010101000001
10000000000000000000000001
10000000000000000000000001
100P000000000000000B0000E1
11111111111111111111111111
10000000000000000000000001
11111111111111111111111111