11111
1E0P1
10001
1C001
11111
