1111111111111111111111111
10000000000000000000000C1
1000000000000000000000001
10000000000B0B00000000001
1000000000010100000000001
1000000000010100000000001
1000000000010100000000001
1000000000010100000000001
100000B00001010000B000001
1000000B000101000B0000001
1000000011110111100000001
100000001111P111100000001
100000001111E111100000001
1111111111111111111111111